5
10
1 0 1 1 1
1 0 1 0 1 
1 0 0 0 1 
1 0 0 1 1
1 0 0 1 1
1 0 0 1 1
1 0 0 1 1
1 0 0 1 1
1 0 0 1 1
1 1 1 1 1

1
2 -2 1 1 2



el primero es width, el segundo es height